
            ┌──────────────────────────────────┐
            │   龍 伯 事 典  ──  灰 燼 輿 圖   │
            └──────────────────────────────────┘

  · · · ··░·░░▒░▒░▒░░░░·░·░·· · · · · · · · · · · ··········· · · · · · · ·~~~~~~~~~
       · ··░░▒▒▒▒▒▒▒░▒░░·░···· ·   ·   ·   · · · ··········· · ·   ·       ~~~~~~~~~
  · · · ··░░▒▒▓▓▓▓▓▒▓▒▒▒▒░░·░·· · · · · · · · · ····░░░·░·░···· · · · · · ~~~~~~~~~~
     · ··░░▒▓█▓███▓█▓▓▒▓▒▒░░···· · · · · · · · ··░·░░░░░░░·░···· ·       ~~~~~~~~~~~
  · · ··░░▒▓█████████████▓▓▒▒░░·················░░▒▒▒▒▓▒▒░▒░░·░·· · · · ·~~~~~~~~~~~
     · ··░▒▓██████████████▓▓░░·░···· ··· ··· ··░·░░▒▒▓▓▓▒▒▒▒░░·· · ·      ~~~~~~~~~~
  · · ··░░▓▓███████████████▓▓▒░·░·············░·▒▒▓▓█▓█▓█▓▓▒▒░░···· · · · ~~~~~~~~~~
     · ··▒▒█████████████████▓▒░░·············░·░░▒▒▓▓███▓▓▒▒▒▒░░·· ·      ~~~~~~~~~~
  · · ··░░▓▓█████████████████▒▒░░·░·░·░·░·░·░·░░▒▒▓████████▓▓▒▒░░·· · · · ~~~~~~~~~~
     · ··░▒▓▓██████▲████████▓▓▒▒░░·░·░·░·░·░·░·░░▒▓███████▓▓▒▒░░·· ·     ~~~~~~~~~~~
    · ··░░▒▒█████████████████▓▒░░░░·░·░·░·░·░·░░▒▒▓▓████▲██▓▓▒▒░░·· ·   ·~~~~~~~~~~~
     · ··░░▒▒▓██████████████▓▓░░░░·············░░▒▒▓▓█████▓█▓▓░░·· ·      ~~~~~~~~~~
  · · ····░░▒▒█████████████▓▓▒▒░░·░·············░░▒▒▓▓☒████▓▓▒▒░░·· · ·   ·~~~~~~~~~
       · ··░░▒▒▓▓█████████▓▓▒▒░░···· · ≈≈≈≈≈   ··░░▒▒⊙▓▓▓▓▓▓▒▒░░·· ·        ~~~~~~~~
    · · ····░░▒▒▓▓█▓█▓█▓▓▓▓▒▒░░···≈≈≈≈≈≈≈≈≈≈≈≈≈≈≈≈░·░░▒▒▓▒▓▒▓▒▒░░·· ·   · ~~~~~~~~~~
         · ··░░▒▒▒▒▒▒▓▒▒▒▒░░·░≈≈≈≈               ≈≈≈≈≈·░░▒░▒░░·░··      ~~~~~~~~~~~~
  ·   · · ····░░░░▒░▒░▒░░░░≈≈≈≈·· · · ·           ···≈≈≈≈░░░░·░·· · ·~~~~~~~~~~~~~~~
           · ····░·░·░·░≈≈≈··· · ·                   · ·≈≈·· ···  ~~~~~~~~~~~~~~~~~~
              · ··············· · · ·               · · ≈ · · · · ~~~~~~~~~~~~~~~~~~
                 · · · · · · · · ·                      ≈          ~~~~~~~~~~~~~~~~~
              ☒ · ··· ··· ··· · · ·                     ≈     ·   · ~~~~~~~~~~~~~~~~
   ≈ ░ ≈ ░ ≈ ░ ≈   · · · · · · ·                        ≈            ~~~~~~~~~~~~~~~
  ≈ ≈░≈ ≈░≈ ⊙░≈ ≈ · · · · · · ·                         ≈            ~~~~~~~~~~~~~~~
   ░ ≈ ░ ≈ ░ ≈ ░                                        ≈            ~~~~~~~~~~~~~~~
  ≈░≈ ≈░≈ ≈░≈ ≈░≈     ·   ·                             ≈            ~~~~~~~~~~~~~~~
   ≈ ░ ≈ ░ ≈ ░ ≈                                        ≈             ~~~~~~~~~~~~~~
  ≈ ≈░≈ ≈░≈ ≈░≈ ≈                                       ≈              ~~~~~~~~~~~~~
   ░ ≈ ░ ≈ ░ ≈ ░                              ⊙         ≈              ~~~~~~~~~~~~~
  ≈░≈ ≈░≈ ≈░≈ ≈░≈     ·                                 ≈              ~~~~~~~~~~~~~
   ≈ ░ ≈ ░ ≈ ░ ≈                                        ≈             ~~~~~~~~~~~~~~
  ≈ ≈░≈ ≈░≈ ≈░≈ ≈   · · ·                               ≈             ~~~~~~~~~~~~~~
   ░ ≈ ░ ≈ ░ ≈ ░     ·                                                ~~~~~~~~~~~~~~
  ≈░≈ ≈░≈ ≈░≈ ≈░≈ · · ··· ·                                              ~~~~~~~~~~~
   ≈ ░ ≈ ░ ≈ ░ ≈   · · · ·                                                 ~~~~~~~~~
                    ··☒ · · ·                                                 ~~~~~~
                     ⊙ · ·                                                    ~~~~~~
                  · · ··· ·                                                  ~~~~~~~
                       ·                                                   ~~~~~~~~~
                    · · ·                                                ~~~~~~~~~~~
                                                                        ~~~~~~~~~~~~
                                      ○                                 ~~~~~~~~~~~~
                                                                        ~~~~~~~~~~~~
                                                                        ~~~~~~~~~~~~
                                                                       ~~~~~~~~~~~~~
                                                                      ~~~~~~~~~~~~~~
                                                                      ~~~~~~~~~~~~~~

  ┌─────────────────────────────────────────────────────────────┐
  │  符號密度 = 海拔高度    疏  ·░▒▓█ 密                       │
  │                                                             │
  │  ▲ 蒼梧嶺 (NW)    ▲ 鶴嶺 (NE)    ⊙ 地淵入口 ×4          │
  │  ☒ 鶴鳴殿遺址     ☒ 玄甲塢遺址    ☒ 鐵劍門遺址          │
  │  ○ 灰燼鎮 (玩家起點)              ~ 龍伯海 / 河 / 沼      │
  └─────────────────────────────────────────────────────────────┘
